{
    "sprite": "maps/hub.png",
    "size": {
        "x": 15,
        "y": 15,
        "z": 5
    },
    "center":{
        "x": 7,
        "y": 7,
        "z": 4
    },
    "anchor": {
        "x": 177,
        "y": 89
    },
    "heights":[
        [0, 0, 0, 0, 0, 4, 4, 4, 4, 4, 0, 0, 0, 0, 0],
        [0, 0, 0, 4, 4, 4, 4, 4, 4, 4, 4, 4, 0, 0, 0],
        [0, 0, 4, 4, 4, 4, 4, 4, 4, 4, 4, 4, 4, 0, 0],
        [0, 4, 4, 4, 4, 4, 4, 4, 4, 4, 4, 4, 4, 4, 0],
        [0, 4, 4, 4, 4, 4, 4, 4, 4, 4, 4, 4, 4, 4, 0],
        [4, 4, 4, 4, 4, 4, 4, 4, 4, 4, 4, 4, 4, 4, 4],
        [4, 4, 4, 4, 4, 4, 4, 4, 4, 4, 4, 4, 4, 4, 4],
        [4, 4, 4, 4, 4, 4, 4, 4, 4, 4, 4, 4, 4, 4, 4],
        [4, 4, 4, 4, 4, 4, 4, 4, 4, 4, 4, 4, 4, 4, 4],
        [4, 4, 4, 4, 4, 4, 4, 4, 4, 4, 4, 4, 4, 4, 4],
        [0, 4, 4, 4, 4, 4, 4, 4, 4, 4, 4, 4, 4, 4, 0],
        [0, 4, 4, 4, 4, 4, 4, 4, 4, 4, 4, 4, 4, 4, 0],
        [0, 0, 4, 4, 4, 4, 4, 4, 4, 4, 4, 4, 4, 0, 0],
        [0, 0, 0, 4, 4, 4, 4, 4, 4, 4, 4, 4, 0, 0, 0],
        [0, 0, 0, 0, 0, 4, 4, 4, 4, 4, 0, 0, 0, 0, 0]
    ]
}